11111111111111111111111111111111
11............................11
1..............................1
1..............................1
1...........111................1
1.......1111111111111111.......111
1.......1..............1.M.......1
1.......1...C..........1.........1
1.......1..............1.........1
1.......11111111111111111111111111
1.......1...C..................1
1.......1......11..............1
1..........M...11......1.......1
1......................1....M..1
1.......1..............1.......1
1...11111111111111111111.......1
1...1.C.1...........M..1.......1
1...1...1..............1.......1
1.C.1...........1......1.......1
11111...........1......1.......1
1...............1..............1
1.P.............1..............1
11111111111111111111111111111111
11111111111111111111111111111111